#####################
#T##     #######TR###
#### ### ############
####F### ####     ###
###R ###      ### ###
#### #T##########  E#
#CP  #######R########
##T#####R#T##########