###########
#####C#####
##### #####
##### #####
##### #####
##### #####
#         #
#    P    #
#         #
###########