####################
##      E###      E#
#R ##R#####R ##R####
##     T####     T##
#####TF########TF###
####   #######   ###
###R ##T#####R ##T##
#### R######## R####
#CP  ######CP  #####
####################