###########
##      E##
#R ##R#####
##     T###
#####TF####
####   ####
###R ##T###
#### R####P
#C   ######
###########
###########